0x02 0x01 0x00 0x48 0x00 0x18 0x00
0x00 0x02 0x01 0x00 0x65 0x00 0x18
0x00 0x00 0x02 0x01 0x00 0x6c 0x00
0x18 0x00 0x00 0x02 0x01 0x00 0x6c
0x00 0x18 0x00 0x00 0x02 0x01 0x00
0x6f 0x00 0x18 0x00 0x00 0x02 0x01
0x00 0x20 0x00 0x18 0x00 0x00 0x02
0x01 0x00 0x57 0x00 0x18 0x00 0x00
0x02 0x01 0x00 0x6f 0x00 0x18 0x00
0x00 0x02 0x01 0x00 0x72 0x00 0x18
0x00 0x00 0x02 0x01 0x00 0x6c 0x00
0x18 0x00 0x00 0x02 0x01 0x00 0x64
0x00 0x18 0x00 0x00 0x02 0x01 0x00
0x0a 0x00 0x18 0x00 0x00 0xFF
